0 0 0 0 0 0 0 0 0 0
6 7 6 7 6 7 6 7 6 7
6 7 6 7 6 7 6 7 6 7
6 7 6 7 6 7 6 7 6 7
6 7 6 7 6 7 6 7 6 7
6 6 6 6 6 6 6 6 6 6
6 7 6 7 6 7 6 7 6 7
6 7 6 7 6 7 6 7 6 7
6 7 6 7 6 7 6 7 6 7
6 7 6 7 6 7 6 7 6 7